######################################################################################################
#!                                                                                                   #
#                                                                                                    #
#                                                                                                    #
#              ######   # # # #####  ###  ###              #  #### #  ###  ##                        #
#              #          ###               #              #                #  #                     #
#              #            #                                               #   #  #                 #
#                           #               #              #                ##                       #
#              #            ########  #  ####              #######          #  #                    !#
#              ##    ### #  #               #              #     #          #         #              #
#              #            #               #                    #                                   #
#              #                            #                               #                        #
#                           ###  #### ## #  #              #                                         #
#              #            #                              # ########  #  ###          ## # #        #
#              #            #                                                          #    #        #
#                           #                                                               #        #
#              #### #### ####                                                          ######        #
#                                                                                                    #
#                                   !                                                                #
######################################################################################################k